Hon Anthony Albanese MP: Member for Grayndler, New South Wales
Mr John Alexander OAM, MP: Member for Bennelong, New South Wales
Dr Anne Aly MP: Member for Cowan, Western Australia
Hon Karen Andrews MP: Member for McPherson, Queensland
Hon Kevin Andrews MP: Member for Menzies, Victoria
Mr Adam Bandt MP: Member for Melbourne, Victoria
Ms Julia Banks MP: Member for Chisholm, Victoria
Hon Sharon Bird MP: Member for Cunningham, New South Wales
Hon Chris Bowen MP: Member for McMahon, New South Wales
Mr Russell Broadbent MP: Member for McMillan, Victoria
Hon Scott Buchholz MP: Member for Wright, Queensland
Hon Tony Burke MP: Member for Watson, New South Wales
Hon Linda Burney MP: Member for Barton, New South Wales
Hon Mark Butler MP: Member for Port Adelaide, South Australia
Ms Terri Butler MP: Member for Griffith, Queensland
Hon Anthony Byrne MP: Member for Holt, Victoria
Dr Jim Chalmers MP: Member for Rankin, Queensland
Mr Nick Champion MP: Member for Wakefield, South Australia
Hon Darren Chester MP: Member for Gippsland, Victoria
Ms Lisa Chesters MP: Member for Bendigo, Victoria
Mr George Christensen MP: Member for Dawson, Queensland
Hon Jason Clare MP: Member for Blaxland, New South Wales
Ms Sharon Claydon MP: Member for Newcastle, New South Wales
Hon David Coleman MP: Member for Banks, New South Wales
Hon Julie Collins MP: Member for Franklin, Tasmania
Mr Pat Conroy MP: Member for Shortland, New South Wales
Hon Mark Coulton MP: Member for Parkes, New South Wales
Mr Chris Crewther MP: Member for Dunkley, Victoria
Mr Milton Dick MP: Member for Oxley, Queensland
Hon Mark Dreyfus QC, MP: Member for Isaacs, Victoria
Hon Damian Drum MP: Member for Murray, Victoria
Hon Peter Dutton MP: Member for Dickson, Queensland
Hon Justine Elliot MP: Member for Richmond, New South Wales
Hon Warren Entsch MP: Member for Leichhardt, Queensland
Hon Trevor Evans MP: Member for Brisbane, Queensland
Mr Jason Falinski MP: Member for Mackellar, New South Wales
Hon Joel Fitzgibbon MP: Member for Hunter, New South Wales
Hon Paul Fletcher MP: Member for Bradfield, New South Wales
Ms Nicolle Flint MP: Member for Boothby, South Australia
Dr Mike Freelander MP: Member for Macarthur, New South Wales
Hon Josh Frydenberg MP: Member for Kooyong, Victoria
Hon Andrew Gee MP: Member for Calare, New South Wales
Mr Steve Georganas MP: Member for Hindmarsh, South Australia
Mr Andrew Giles MP: Member for Scullin, Victoria
Hon Dr David Gillespie MP: Member for Lyne, New South Wales
Mr Ian Goodenough MP: Member for Moore, Western Australia
Mr Patrick Gorman MP: Member for Perth, Western Australia
Mr Luke Gosling OAM, MP: Member for Solomon, Northern Territory
Ms Celia Hammond MP: Member for Curtin, Western Australia
Mr Ross Hart MP: Member for Bass, Tasmania
Mr Andrew Hastie MP: Member for Canning, Western Australia
Hon Alex Hawke MP: Member for Mitchell, New South Wales
Mr Chris Hayes MP: Member for Fowler, New South Wales
Hon Sarah Henderson MP: Member for Corangamite, Victoria
Mr Julian Hill MP: Member for Bruce, Victoria
Mr Kevin Hogan MP: Member for Page, New South Wales
Hon Luke Howarth MP: Member for Petrie, Queensland
Hon Greg Hunt MP: Member for Flinders, Victoria
Hon Ed Husic MP: Member for Chifley, New South Wales
Hon Steve Irons MP: Member for Swan, Western Australia
Mr Stephen Jones MP: Member for Whitlam, New South Wales
Hon Barnaby Joyce MP: Member for New England, New South Wales
Hon Bob Katter MP: Member for Kennedy, Queensland
Ms Ged Kearney MP: Member for Batman, Victoria
Mr Craig Kelly MP: Member for Hughes, New South Wales
Hon Dr Mike Kelly AM, MP: Member for Eden-Monaro, New South Wales
Mr Matt Keogh MP: Member for Burt, Western Australia
Mr Peter Khalil MP: Member for Wills, Victoria
Hon Catherine King MP: Member for Ballarat, Victoria
Ms Madeleine King MP: Member for Brand, Western Australia
Mr Andrew Laming MP: Member for Bowman, Queensland
Hon Michelle Landry MP: Member for Capricornia, Queensland
Mr Julian Leeser MP: Member for Berowra, New South Wales
Hon Dr Andrew Leigh MP: Member for Fenner, Australian Capital Territory
Hon Sussan Ley MP: Member for Farrer, New South Wales
Hon David Littleproud MP: Member for Maranoa, Queensland
Hon Nola Marino MP: Member for Forrest, Western Australia
Hon Richard Marles MP: Member for Corio, Victoria
Ms Fiona Martin MP: Member for Reid, New South Wales
Ms Emma McBride MP: Member for Dobell, New South Wales
Hon Michael McCormack MP: Member for Riverina, New South Wales
Mrs Melissa McIntosh MP: Member for Lindsay, New South Wales
Hon Dr John McVeigh MP: Member for Groom, Queensland
Mr Brian Mitchell MP: Member for Lyons, Tasmania
Mr Rob Mitchell MP: Member for McEwen, Victoria
Hon Scott Morrison MP: Member for Cook, New South Wales
Hon Ben Morton MP: Member for Tangney, Western Australia
Hon Shayne Neumann MP: Member for Blair, Queensland
Mr Ted O'Brien MP: Member for Fairfax, Queensland
Mr Llew O'Brien MP: Member for Wide Bay, Queensland
Hon Brendan O'Connor MP: Member for Gorton, Victoria
Mr Ken O'Dowd MP: Member for Flynn, Queensland
Ms Clare O'Neil MP: Member for Hotham, Victoria
Ms Cathy O'Toole MP: Member for Herbert, Queensland
Ms Julie Owens MP: Member for Parramatta, New South Wales
Mr Tony Pasin MP: Member for Barker, South Australia
Mr Gavin Pearce MP: Member for Braddon, Tasmania
Mr Graham Perrett MP: Member for Moreton, Queensland
Dr Kerryn Phelps AM, MP: Member for Wentworth, New South Wales
Hon Keith Pitt MP: Member for Hinkler, Queensland
Hon Tanya Plibersek MP: Member for Sydney, New South Wales
Hon Christian Porter MP: Member for Pearce, Western Australia
Hon Melissa Price MP: Member for Durack, Western Australia
Mr Rowan Ramsey MP: Member for Grey, South Australia
Hon Amanda Rishworth MP: Member for Kingston, South Australia
Hon Stuart Robert MP: Member for Fadden, Queensland
Ms Michelle Rowland MP: Member for Greenway, New South Wales
Ms Joanne Ryan MP: Member for Lalor, Victoria
Ms Rebekha Sharkie MP: Member for Mayo, South Australia
Hon Bill Shorten MP: Member for Maribyrnong, Victoria
Hon Tony Smith MP: Member for Casey, Victoria
Hon Warren Snowdon MP: Member for Lingiari, Northern Territory
Ms Anne Stanley MP: Member for Werriwa, New South Wales
Ms Zali Steggall OAM, MP: Member for Warringah, New South Wales
Hon Michael Sukkar MP: Member for Deakin, Victoria
Ms Meryl Swanson MP: Member for Paterson, New South Wales
Hon Angus Taylor MP: Member for Hume, New South Wales
Hon Dan Tehan MP: Member for Wannon, Victoria
Ms Susan Templeman MP: Member for Macquarie, New South Wales
Hon Matt Thistlethwaite MP: Member for Kingsford Smith, New South Wales
Ms Kate Thwaites MP: Member for Jagajaga, Victoria
Hon Alan Tudge MP: Member for Aston, Victoria
Ms Maria Vamvakinou MP: Member for Calwell, Victoria
Mr Bert van Manen MP: Member for Forde, Queensland
Mr Ross Vasta MP: Member for Bonner, Queensland
Mr Andrew Wallace MP: Member for Fisher, Queensland
Mr Tim Watts MP: Member for Gellibrand, Victoria
Mrs Lucy Wicks MP: Member for Robertson, New South Wales
Mr Andrew Wilkie MP: Member for Denison, Tasmania
Mr Josh Wilson MP: Member for Fremantle, Western Australia
Mr Rick Wilson MP: Member for O'Connor, Western Australia
Mr Tim Wilson MP: Member for Goldstein, Victoria
Hon Jason Wood MP: Member for La Trobe, Victoria
Hon Ken Wyatt AM, MP: Member for Hasluck, Western Australia
Mr Terry Young MP: Member for Longman, Queensland
Mr Tony Zappia MP: Member for Makin, South Australia
Mr Trent Zimmerman MP: Member for North Sydney, New South Wales
